..........................#######....
..........................#.....#....
..........................#.#########
..........................#.#...#...#
..........................#.#...#...#
..........................#.#...#...#
..........................#####.#...#
............................#.#.#...#
............................#.#.#...#
............................#.#.#...#
............................#####...#
..............................#.....#
............................#########
............................#.#......
......................#########......
............................#........
............................#........
............................#........
....####^...........#########........
....#...............#................
....#...............#................
....#...............#................
....#...............#................
....#...............#................
###########.....###########..........
#...#.....#.....#...#.....#..........
#...#.#########.#...#####.#..........
#...#.#...#...#.#.......#.#..........
#...#######...#.#.......#.#..........
#.....#.......#.#.......#.#..........
#######.......#.#.......#.#..........
..............#.#.......#.#..........
..............#.#########.#######....
..............#.................#....
..............#######.#########.#....
....................#.#.......#.#....
....................#.#.......#.#....
....................#.#.......#.#....
....................#.###########....
....................#.........#......
....................#.........#......
....................#.........#......
....................###########......

